66
15
51 51 51 51 51 51 51 51 51 51 51 51 51 51 51 51 51 51 51 51 51 51 51 51 51 51 51 51 51 51 51 51 51 51 51 51 51 51 51 51 51 51 51 51 51 51 51 51 51 51 51 51 51 51 51 51 51 51 51 51 51 51 51 51 51 51 
51 51 51 51 51 51 51 51 51 51 51 51 51 51 51 51 51 51 51 51 51 51 51 51 51 51 51 51 51 51 51 51 51 51 51 51 51 51 51 51 51 51 51 51 51 51 51 51 51 51 51 51 51 51 51 51 51 51 51 51 51 51 51 51 51 51 
51 51 51 51 51 51 51 51 51 51 51 51 51 51 51 51 51 51 51 51 51 51 51 51 51 51 51 51 51 51 51 51 51 51 51 51 51 51 51 51 51 51 51 51 51 51 51 51 51 51 51 51 51 51 51 51 51 51 51 51 51 51 51 51 51 51 
54 54 54 54 54 54 54 54 54 54 54 33 51 51 51 51 51 35 54 54 54 54 54 54 54 54 54 54 54 54 54 54 54 33 51 51 51 51 51 51 51 51 51 51 51 51 51 51 51 51 51 51 51 51 51 51 51 51 51 51 51 51 51 51 51 51 
0 0 0 0 0 19 0 0 0 0 0 53 54 54 54 54 54 55 0 0 0 0 19 0 0 0 0 0 0 0 0 0 0 53 54 54 33 51 51 51 51 51 51 51 51 51 51 51 51 51 51 51 51 51 51 51 35 54 54 54 54 54 54 54 54 54 
0 0 3 0 0 19 0 0 0 0 0 0 0 0 0 0 0 0 0 0 0 0 19 0 0 0 0 0 0 0 0 0 0 0 0 0 53 54 54 54 54 54 54 54 54 54 54 54 54 54 54 54 54 54 54 54 55 0 0 0 0 0 0 13 0 0 
0 0 4 0 0 19 0 0 0 0 0 3 0 0 0 9 0 0 3 0 0 2 29 0 0 3 0 0 0 9 2 0 0 3 0 0 0 0 0 0 0 0 0 19 0 0 0 0 0 19 0 0 0 0 0 0 0 0 0 0 3 0 0 23 0 0 
31 31 31 31 31 31 31 32 0 10 0 0 0 10 0 29 0 0 0 0 0 30 32 0 0 0 9 0 0 30 32 0 0 0 0 0 0 9 0 0 0 0 0 19 0 0 0 0 0 19 0 0 0 0 0 0 0 2 9 0 0 0 0 23 0 0 
51 51 51 51 51 51 51 52 31 31 31 31 31 31 31 31 31 31 32 0 0 40 42 0 0 30 32 0 0 40 42 0 0 30 31 16 0 19 0 0 0 3 0 19 0 2 0 0 0 19 0 3 0 0 9 0 0 30 31 31 31 31 31 31 31 31 
51 51 51 51 51 51 51 51 51 51 51 51 51 51 51 51 51 51 42 0 0 40 42 0 0 40 42 0 0 40 42 0 0 40 42 26 0 19 0 10 0 0 4 29 0 30 32 0 0 19 0 0 0 0 19 0 4 40 51 51 51 51 51 51 51 51 
51 51 51 51 51 51 51 51 51 51 51 51 51 51 51 51 51 51 42 0 0 40 42 0 0 40 42 0 0 40 42 0 0 40 52 31 31 31 31 31 31 31 31 31 31 50 52 31 31 31 31 31 31 31 31 31 31 50 51 51 51 51 51 51 51 51 
51 51 51 51 51 51 51 51 51 51 51 51 51 51 51 51 51 51 42 0 0 40 42 0 0 40 42 0 0 40 42 0 0 40 51 51 51 51 51 51 51 51 51 51 51 51 51 51 51 51 51 51 51 51 51 51 51 51 51 51 51 51 51 51 51 51 
51 51 51 51 51 51 51 51 51 51 51 51 51 51 51 51 51 51 42 0 0 40 42 0 0 40 42 0 0 40 42 0 0 40 51 51 51 51 51 51 51 51 51 51 51 51 51 51 51 51 51 51 51 51 51 51 51 51 51 51 51 51 51 51 51 51 
51 51 51 51 51 51 51 51 51 51 51 51 51 51 51 51 51 51 42 0 0 40 42 0 0 40 42 0 0 40 42 0 0 40 51 51 51 51 51 51 51 51 51 51 51 51 51 51 51 51 51 51 51 51 51 51 51 51 51 51 51 51 51 51 51 51 
51 51 51 51 51 51 51 51 51 51 51 51 51 51 51 51 51 51 52 0 0 50 52 0 0 50 52 0 0 50 52 0 0 50 51 51 51 51 51 51 51 51 51 51 51 51 51 51 51 51 51 51 51 51 51 51 51 51 51 51 51 51 51 51 51 51 
