73
23
34 45  0 43 51 51 51 51 51 51 44 51 51 51 51 51 51 51 51 51 51 51 51 51 51 51 51 51 51 51 51 51 51 51 51 51 51 51 44 44 44 44 44 44 44 44 44 44 44 44 51 51 51 51 51 51 51 51 44 44 44 44 44 51 51 51 51 51 51 51 51 51 51 
44 45  0 43 51 51 51 51 44 51 51 51 51 51 51 51 51 51 51 51 51 44 44 44 44 51 51 51 51 51 51 44 51 51 51 51 51 51 44 51 51 51 51 51 51 51 51 51 51 51 51 51 51 51 51 51 51 44 44 44 51 51 51 51 51 51 51 51 35 54 54 54 54 
34 45  0 43 51 51 51 51 51 51 51 51 51 51 44 44 44 44 44 44 51 51 51 51 44 51 51 51 51 51 51 44 51 51 51 51 51 44 44 51 51 44 51 51 51 51 51 35 54 54 54 54 54 33 51 51 44 44 44 44 51 51 51 51 35 54 54 54 55  0  0  0  0 
44 45  0 43 51 44 51 51 51 51 51 44 44 44 44 51 51 51 51 51 51 51 51 51 51 51 51 51 51 51 51 44 51 51 51 51 51 44 51 51 51 44 51 51 51 51 35 54  0  0  0  0  0 36 33 34 44 44 44 51 51 51 35 54 54  0  0  0  0  0  0  0  0 
34 45  0 43 51 51 51 44 51 51 44 51 51 51 51 51 51 51 51 51 51 51 51 51 51 51 51 51 51 51 51 44 51 51 51 51 51 44 51 51 44 51 51 51 51 34 45  0  0  0  0  0  0  0 43 34 51 51 51 51 35 54 54  0  0  0  0  0  0  0  0 13  0 
44 45  0 43 51 51 44 44 51 51 44 51 51 51 51 51 44 44 44 44 44 44 44 44 44 44 44 44 51 51 51 44 44 51 51 51 51 44 51 44 44 51 51 51 34 35 55  0  0  0  0  0  0  0 43 34 51 51 35 54 55  0  0  0  0  0  0  0  0  0  0 23  0 
34 45  0 43 44 51 51 51 51 51 44 51 51 51 44 44 51 51 51 51 51 51 51 51 51 41 51 51 51 51 51 51 44 44 51 51 51 44 44 44 51 51 51 34 35 55  0  0  0  0  0  0  0  0 53 33 34 35 36  0  0  0  0  0  0  0  0  0  0  3  0 23  0 
34 45  0 43 44 51 33 51 51 51 51 44 44 44 44 51 51 51 51 51 51 51 51 51 51 51 51 51 51 51 51 51 51 44 44 51 51 51 44 44 51 51 34 35 55  0  0  0  0  0  0  0  0  0  0 36 36 36  0  0  0  0  0  0  0  0  0  0  0  0 30 31 31 
35 55  0 53 54 54 54 54 54 33 51 51 51 51 51 51 51 51 41 51 51 51 41 51 51 51 51 51 51 51 51 51 51 51 51 44 44 44 51 51 51 51 35 55  0  0  0  0  0  0  0  0  0  0  0  0 53  0  0  0  0  0  0  0  0  0  0  0 30 31 50 51 51 
45  0  0  0  0  0  0  0  0 43 51 51 51 51 51 51 51 51 51 51 51 51 51 51 51 51 51 51 51 51 51 51 51 51 51 51 51 51 51 51 51 35 55  0  0  0  0  0  0  0  0  0  0  0  0  0  0  0  0  0  0  0  0  0  0  0  0 30 50 51 51 51 51 
45  9  0  0  0  0  0  0  0 43 51 51 51 51 35 55 54 54 54 54 54 54 54 54 54 54 54 54 54 54 54 54 54 54 33 51 51 51 51 51 51 45  0  0  0  0  0  0  0  0  0  0  3  0 16  0  0  0  0  0  0  0  0  0  0  0 30 50 51 51 51 51 51 
45 19  0  3  0  0  0  0  0 43 51 51 51 51 45  0  0  0 19  0  0  0  0  0  0  0  0  0  0  0  0  0  0  0 43 51 51 51 51 51 35 54  0  0  0  0  0  0  0  0  0  0  0  0 26  0  9  0  0  0  0  0  0  0  0  4 31 51 51 51 51 44 51 
45 19  0  0  0  0 16  0  0 43 51 33 51 35 45  0  0  0  0  3  0  0  0  0  3  0  0  0  9  0  0  0  0  0 43 51 51 51 51 51 45  0  0  0  0  0  0  0  0  0  0 30 31 31 31 31 31 32  0  0  0  0  0  0  0 30 50 51 51 51 44 51 51 
45 29  0  0  0  0 26  0  0 53 54 54 54 54 55  0  0  0  9  0  0  1  0  0  0  0  0  0 29  0  0  0  0  0 53 54 54 54 54 54 55  0  0  0  0  0  0  3  0  0 31 50 51 51 51 51 51 52 32  0  0  0  3  0  0 31 51 51 51 51 44 51 51 
52 31 31 31 31 31 32  0  0 19  0  0  0  0 19  0  0  0 19 30 31 32  0 30 31 32  0 30 31 31 32  0  0  0 19  0  0  0  0  0 19  0  0 11 12 15  0  4  0 31 50 51 51 51 51 51 51 51 52 32  0 10  0  0 30 50 51 51 51 51 44 51 51 
34 44 51 51 51 51 42  0  0 19  3  0 16  0 19  0  0  0 30 50 51 42  0 40 52 42  0 40 51 52 42  0  3  0 19  0  0  3  0  0 19  0 20 21 22 25 30 31 31 50 51 51 51 44 51 51 51 51 51 52 31 31 31 31 50 51 51 51 51 51 44 51 51 
34 51 51 51 51 51 42  0  0 29  0  0 26  0 29  0  0  0 40 51 51 52 31 50 41 52 31 50 51 51 42  1  0  0 29  0  0  0 10  0 29  0 30 31 31 31 50 51 51 51 51 51 51 51 51 51 51 51 51 51 51 51 51 51 51 51 51 51 51 44 44 51 51 
34 51 44 51 44 51 52 31 31 31 31 31 31 31 31 31 31 31 50 51 41 51 51 51 51 51 51 51 41 51 52 31 31 31 31 31 31 31 31 31 31 31 50 51 51 51 51 51 51 51 51 51 51 51 51 51 51 51 51 51 51 51 51 51 51 51 51 51 51 51 51 51 51 
34 51 51 51 44 51 51 51 51 51 51 51 51 51 51 51 51 50 51 51 51 51 41 51 51 51 51 51 51 51 51 51 51 51 51 51 51 51 51 51 51 51 51 51 51 51 51 51 51 51 51 51 51 51 51 51 51 51 51 51 51 51 51 51 51 51 51 51 51 51 51 51 51 
34 44 51 44 44 51 51 44 44 51 51 51 51 51 51 44 51 51 51 51 51 51 51 51 51 51 41 41 51 51 51 51 51 51 51 51 51 51 44 44 51 51 51 51 51 44 51 51 51 51 51 44 51 51 51 51 51 44 51 51 51 51 51 51 51 44 51 51 51 51 51 51 51 
34 51 51 44 51 51 51 51 51 51 44 51 51 51 51 51 51 51 51 51 44 51 51 51 51 51 51 51 51 51 51 51 51 51 51 51 51 51 51 51 51 44 44 51 44 51 44 51 51 51 51 51 51 51 51 51 51 51 51 51 51 51 51 51 44 44 51 51 51 51 51 51 51 
34 51 44 44 51 51 51 44 51 51 51 51 51 44 51 51 51 51 51 51 51 51 51 51 51 51 51 51 51 51 51 51 51 51 51 51 51 51 51 51 51 51 51 51 51 51 51 51 44 51 44 51 44 51 51 51 51 51 51 51 51 51 51 44 44 51 51 51 51 51 51 51 51 
34 44 51 51 51 51 51 51 51 51 51 51 51 51 51 51 51 51 51 51 51 51 51 51 51 51 51 51 51 51 51 51 51 51 51 51 51 51 51 51 51 51 51 51 51 51 51 51 51 51 51 51 51 51 44 44 51 44 44 44 44 44 44 44 51 51 51 51 51 51 51 51 51 
