90
30
52 52 52 52 52 52 52 52 52 52 52 52 52 52 52 52 52 52 52 52 52 52 52 52 52 52 52 52 52 52 52 52 52 52 52 52 52 52 52 52 52 52 52 52 52 52 52 52 52 52 52 52 52 52 52 52 52 52 52 52 52 52 52 52 52 52 52 52 52 52 52 52 52 52 52 52 52 52 52 52 52 52 52 52 52 52 52 52 52 52 
52 52 52 52 52 52 52 52 52 52 52 52 52 52 52 52 52 52 52 52 52 52 52 52 52 52 52 52 52 52 52 52 52 52 52 52 52 52 52 52 52 52 52 52 52 52 52 52 52 52 52 52 52 52 52 52 52 52 52 52 52 52 52 52 52 52 52 52 52 52 52 52 52 52 52 52 52 52 52 52 52 52 52 52 52 52 52 52 52 52 
52 52 52 52 52 52 52 52 52 52 52 52 52 52 52 52 52 52 52 52 52 52 52 52 52 52 52 52 52 52 52 52 52 52 52 52 52 52 52 52 52 52 52 52 52 52 52 52 52 52 52 52 52 52 52 52 52 52 52 52 52 52 52 52 52 52 52 52 52 52 52 52 52 52 52 52 52 52 52 52 52 52 52 52 52 52 52 52 52 52 
52 52 52 52 52 52 52 52 52 52 52 52 52 52 52 52 50 15 15 15 15 15 15 15 10 11 15 15 15 15 15 15 15 15 16 21 15 15 15 16 21 60 52 52 52 52 52 52 52 52 52 52 52 52 52 52 52 52 52 52 52 52 52 52 52 52 52 52 52 52 52 52 52 52 52 52 52 52 52 52 52 52 52 52 52 52 52 52 52 52 
52 52 52 52 52 52 52 52 52 52 52 52 52 52 52 50 11 0 0 0 0 0 0 0 20 21 0 0 0 0 0 0 0 0 20 21 0 0 0 20 21 0 0 15 15 16 60 52 52 52 52 52 52 52 52 52 52 52 52 52 52 52 52 52 52 52 52 52 52 52 52 52 52 52 52 52 52 52 52 52 52 52 52 52 52 52 52 52 52 52 
52 52 52 52 52 52 52 52 52 52 52 52 52 52 50 20 21 0 0 0 0 0 0 0 20 21 0 0 0 0 0 0 0 0 20 21 0 0 0 20 21 0 0 0 0 20 21 0 60 52 52 52 52 52 52 52 52 52 52 52 52 52 52 52 52 52 52 52 52 52 52 52 52 52 52 52 52 52 52 52 52 52 52 52 52 52 52 52 52 52 
52 52 52 52 52 52 52 52 52 52 52 52 52 50 0 20 21 0 0 0 0 0 0 0 20 21 0 0 0 0 0 0 0 0 20 21 0 0 0 20 21 0 0 0 0 20 21 0 0 0 15 15 16 15 15 60 52 52 52 52 52 52 52 52 52 52 52 52 52 52 52 52 52 52 52 52 52 52 52 52 52 52 52 52 52 52 52 52 52 52 
52 52 52 52 52 52 52 52 52 52 52 52 50 0 0 20 21 0 0 0 0 0 0 0 20 21 0 0 0 0 0 0 0 0 20 21 0 0 0 20 21 0 0 0 0 20 21 0 0 0 0 0 20 21 0 0 15 15 15 15 15 60 52 52 52 52 52 52 52 52 52 52 52 52 52 52 52 52 52 52 52 52 52 52 52 52 52 52 52 52 
52 52 52 52 52 52 52 52 52 52 52 50 11 0 0 20 21 0 0 0 0 0 0 0 20 21 0 0 0 0 0 0 0 0 20 21 0 0 0 20 21 0 0 0 0 20 21 0 0 0 0 0 20 21 0 0 0 0 0 0 0 0 15 15 15 15 16 15 15 15 15 15 15 0 60 52 52 52 52 52 52 52 52 52 52 52 52 52 52 52 
52 52 52 52 52 52 52 52 52 52 50 20 21 0 0 20 21 0 0 0 0 0 0 0 20 21 0 0 0 0 0 0 0 0 0 0 0 0 0 0 0 0 0 0 0 20 21 0 0 0 0 0 20 21 0 0 0 0 0 0 0 0 0 0 0 0 20 21 0 0 0 0 0 0 0 0 15 15 16 21 15 15 15 15 15 15 15 15 15 15 
52 52 52 52 52 52 52 52 52 50 0 20 21 0 0 0 0 0 0 0 0 0 0 0 20 21 0 0 0 0 0 0 0 0 0 0 0 0 0 0 0 0 0 0 0 20 21 0 0 0 0 0 20 21 0 0 0 0 0 0 0 0 0 0 0 0 20 21 0 0 0 0 0 0 0 0 0 0 20 21 0 0 0 0 0 0 0 0 0 0 
52 52 52 52 52 52 52 52 50 0 0 20 21 0 0 0 0 0 0 0 0 0 0 0 20 21 0 0 0 0 0 0 0 0 0 0 0 0 0 0 0 0 0 0 0 0 0 0 0 0 0 0 20 21 0 0 0 0 0 0 0 0 0 0 0 0 20 21 0 0 0 0 0 0 0 0 0 0 20 21 0 0 0 0 0 0 0 0 0 0 
52 52 52 52 52 52 52 50 0 0 0 20 21 0 0 0 0 0 0 0 0 0 0 0 20 21 0 0 0 0 0 0 0 0 0 0 0 0 0 0 0 0 0 0 0 0 0 0 0 0 0 0 20 21 0 0 0 0 0 0 0 0 0 0 0 0 20 21 0 0 0 0 0 0 0 0 0 0 0 0 0 0 0 0 0 13 0 0 0 0 
52 52 52 52 52 52 50 0 0 0 0 20 21 0 0 0 0 0 2 3 0 0 0 0 0 0 0 0 0 0 0 0 0 0 0 0 0 0 0 0 0 0 0 0 0 0 0 0 0 0 0 0 20 21 0 0 0 0 0 0 0 0 0 0 0 0 20 21 0 0 0 0 0 0 0 0 0 0 0 0 0 0 0 0 0 23 0 0 0 0 
52 52 52 52 52 50 0 0 0 0 0 0 0 0 0 1 0 41 42 42 32 33 0 0 0 0 0 0 0 0 0 0 0 0 0 0 0 0 0 0 0 0 0 0 0 0 0 0 0 0 0 0 20 21 0 0 0 0 0 0 0 0 0 0 0 0 20 21 0 0 0 0 0 0 0 0 0 0 0 0 0 0 0 0 0 23 0 0 0 0 
0   0  0  0  0 0 0 0 0 0 0 0 0 0 0 41 42 69 52 50 0 0 0 0 0 0 0 0 0 0 0 0 0 0 0 0 0 0 0 0 0 0 0 0 0 0 0 0 0 0 0 0 20 21 0 0 0 0 0 0 0 0 0 0 0 0 20 21 0 0 0 0 0 0 0 0 0 0 0 0 0 0 0 0 41 42 42 14 42 42 
0   0  0  0  0 0 0 0 0 0 0 0 3 41 42 69 52 52 50 0 0 0 0 0 0 0 0 6 0 0 0 0 0 0 0 0 0 0 0 0 0 0 0 0 0 0 0 0 0 0 0 0 0 0 0 0 0 0 0 0 0 0 0 0 0 0 0 0 0 0 0 0 0 0 0 0 0 0 0 0 0 41 42 42 69 52 52 8 52 52 
0   0  0  0  6 0 0 0 3 3 3 0 41 69 52 52 52 50 0 0 0 0 0 0 0 31 42 33 0 0 0 0 0 0 0 0 0 0 0 0 0 0 0 0 0 0 0 0 0 0 0 0 0 0 0 0 0 0 0 0 0 0 0 0 0 0 0 0 0 0 0 0 0 0 0 0 0 41 42 42 42 69 52 52 52 52 52 8 52 52 
42 42 42 42 42 65 42 42 42 42 42 42 69 52 52 52 50 0 0 0 0 0 0 0 0 0 16 21 0 0 0 0 41 43 0 0 0 0 0 0 0 0 0 0 0 0 0 0 0 0 6 0 0 0 0 0 0 0 31 42 33 0 0 0 0 0 0 0 0 0 0 41 42 42 42 42 42 69 52 52 52 52 52 52 52 52 52 8 52 52 
52 52 52 52 52 52 52 52 52 52 52 52 52 52 52 50 0 0 0 0 0 0 0 0 0 0 20 21 0 0 0 0 51 67 42 43 0 0 0 0 0 0 0 0 0 0 0 0 41 42 42 43 0 0 0 0 0 0 0 16 21 0 0 0 0 0 0 0 0 0 41 69 52 52 52 52 52 52 52 52 52 52 52 52 52 52 52 8 52 52 
52 52 52 52 52 52 52 52 52 52 52 52 52 52 50 0 0 0 0 0 0 0 0 0 0 0 20 21 0 0 0 0 51 52 52 67 42 42 42 42 42 42 42 42 42 42 42 42 69 52 52 67 42 42 42 43 0 0 0 20 21 0 0 31 14 33 0 0 0 41 69 52 52 52 52 52 52 52 52 52 52 52 52 52 52 52 52 8 52 52 
52 52 52 52 52 52 52 52 52 52 52 52 52 50 0 0 0 0 0 0 0 0 0 0 0 0 20 21 0 0 0 0 51 52 52 52 52 52 52 52 52 52 52 52 52 52 52 52 52 52 52 52 52 52 52 53 0 0 0 20 21 0 0 0 0 0 0 0 0 51 52 52 52 52 52 52 52 52 52 52 52 52 52 52 52 52 52 8 52 52 
52 52 52 52 52 52 52 52 52 52 52 52 50 0 0 0 0 0 0 0 0 0 0 0 0 0 20 21 0 0 0 0 61 49 52 52 52 52 52 52 52 52 52 52 52 52 52 52 52 52 52 52 52 52 47 63 0 0 0 20 21 0 0 0 0 0 0 0 0 51 52 52 52 52 52 52 52 52 52 52 52 52 52 52 52 52 52 8 52 52 
52 52 52 52 52 52 52 52 52 52 52 50 0 0 0 0 0 0 0 0 0 0 0 0 0 0 20 21 0 0 0 0 0 51 52 52 52 52 52 52 52 52 52 52 52 52 52 52 52 52 52 52 52 47 63 0 0 0 0 0 0 0 0 0 0 0 0 0 0 51 52 52 52 52 52 52 52 52 52 52 52 52 52 52 52 52 52 8 52 52 
52 52 52 52 52 52 52 52 52 52 50 0 0 0 0 0 0 0 0 0 0 0 0 0 0 0 20 21 0 0 0 0 0 51 52 52 52 52 52 52 52 52 52 52 52 52 52 52 52 52 52 52 52 53 0 0 0 0 0 0 0 0 0 0 0 0 0 0 0 51 52 52 52 52 52 52 52 52 52 52 52 52 52 52 52 52 52 8 52 52 
52 52 52 52 52 52 52 52 52 50 0 0 0 0 0 0 0 0 0 0 0 0 0 0 0 0 20 21 0 0 0 0 0 61 62 49 52 52 52 52 52 52 52 52 52 52 52 52 52 52 52 52 47 63 0 0 0 0 0 0 0 0 0 0 0 0 0 0 0 51 52 52 52 52 52 52 52 52 52 52 52 52 52 52 52 52 52 8 52 52 
52 52 52 52 52 52 52 52 50 0 0 0 0 0 0 0 0 0 0 0 0 0 0 0 0 0 20 21 0 0 0 0 0 0 0 51 52 52 52 52 52 52 52 52 52 52 52 52 52 52 52 47 63 0 0 0 0 0 0 0 0 0 0 0 0 0 0 0 0 51 52 52 52 52 52 52 52 52 52 52 52 52 52 52 52 52 52 8 52 52 
52 52 52 52 52 52 52 50 0 0 0 0 0 0 0 0 0 0 0 0 0 0 0 0 0 0 20 21 0 0 0 0 0 0 0 61 49 52 52 52 52 52 52 52 52 52 52 52 52 52 52 53 0 0 0 0 0 0 0 0 0 0 0 0 0 0 0 0 0 51 52 52 52 52 52 52 52 52 52 52 52 52 52 52 52 52 52 8 52 52 
52 52 52 52 52 52 50 0 0 0 0 0 0 0 0 0 0 0 0 0 0 0 0 0 0 0 0 0 0 0 0 0 0 0 0 0 51 52 52 52 52 52 52 52 52 52 52 52 52 52 52 53 0 0 0 0 0 0 0 0 0 0 0 0 0 0 0 0 0 51 52 52 52 52 52 52 52 52 52 52 52 52 52 52 52 52 52 8 52 52 
52 52 52 52 52 50 0 0 0 0 0 0 0 0 0 0 0 0 0 0 0 0 0 0 0 0 0 0 0 0 0 0 0 0 0 0 51 52 52 52 52 52 52 52 52 52 52 52 52 52 52 53 0 0 0 0 0 0 0 0 0 0 0 0 0 0 0 0 0 51 52 52 52 52 52 52 52 52 52 52 52 52 52 52 52 52 52 8 52 52 
