56
16
51 41 51 51 51 51 51 51 51 51 51 51 51 51 51 51 51 51 51 51 51 51 51 51 51 51 51 51 51 51 51 51 51 51 51 51 51 41 51 51 51 51 35 0 0 0 0 0 0 0 0 0 0 0 0 0 
51 51 51 51 51 51 51 41 51 51 51 51 51 51 51 51 51 51 41 51 51 51 51 51 51 51 51 44 41 51 51 51 41 51 51 44 51 51 51 41 51 51 45 0 0 0 0 0 0 0 0 0 0 0 0 0 
51 51 51 51 51 51 51 51 51 51 51 41 51 51 51 51 51 51 51 51 51 51 51 41 51 51 51 51 51 51 51 41 51 51 51 51 41 51 51 51 51 51 45 0 0 0 0 0 0 0 0 0 0 0 0 0 
51 41 51 51 41 41 51 51 51 51 51 51 51 51 51 51 51 41 51 51 51 51 51 51 51 51 41 35 54 54 54 36 54 54 54 54 36 54 54 54 54 33 45 0 0 0 0 0 0 0 0 0 0 0 0 0 
51 51 51 51 51 51 51 41 51 51 51 51 51 41 51 51 51 41 51 51 51 51 41 51 41 51 35 55 0 0 0 19 0 0 0 0 19 0 0 0 0 43 45 0 0 0 0 0 0 0 0 0 0 0 0 0 
51 41 51 51 51 51 51 51 51 51 51 51 51 51 51 51 51 51 51 51 51 51 51 51 51 51 42 0 0 0 0 19 0 3 16 0 19 0 0 0 0 43 45 0 0 0 0 0 0 0 0 0 0 0 0 0 
54 54 54 54 54 54 54 54 54 54 36 54 54 54 54 54 54 54 54 54 54 36 54 54 54 54 55 0 0 0 0 29 0 0 26 0 19 0 0 0 0 53 55 0 0 0 0 0 0 0 0 0 0 0 0 0 
0 0 0 0 0 0 0 0 0 0 9 0 0 0 0 0 0 0 0 0 0 19 0 0 0 0 0 0 0 0 30 31 31 31 31 31 31 32 0 0 0 0 0 0 0 0 0 0 0 0 0 0 0 0 0 0 
0 0 3 0 0 0 0 0 3 0 19 0 0 0 0 0 0 0 0 3 0 19 0 0 0 0 3 0 0 20 40 51 41 51 51 51 41 42 0 0 0 0 0 0 0 0 0 0 0 0 0 0 0 0 13 0 
0 0 0 0 2 2 0 0 0 0 29 0 0 0 0 0 0 0 0 20 30 32 25 2 0 0 0 0 20 30 50 51 51 51 51 51 51 42 0 0 0 0 0 0 0 0 0 0 0 0 0 0 0 0 23 0 
31 31 31 31 31 31 31 31 31 31 31 32 0 4 0 0 0 0 30 31 50 52 31 31 31 31 31 31 31 50 41 51 51 41 51 51 51 42 0 0 0 0 0 0 0 0 0 3 0 0 0 0 0 0 23 0 
51 51 51 51 51 51 51 51 51 51 51 52 31 32 0 0 0 0 40 51 51 44 51 51 51 51 51 51 51 51 51 51 51 51 51 51 51 42 0 0 3 0 0 0 0 0 0 0 0 0 0 30 31 31 31 31 
51 41 51 51 51 51 51 41 51 51 51 51 51 42 0 30 32 0 40 41 51 51 51 41 51 51 51 51 51 51 51 51 41 51 51 51 51 42 0 0 0 0 0 30 32 0 0 31 32 0 0 40 51 51 51 51 
51 51 51 51 41 51 51 51 51 51 51 51 51 42 0 40 42 0 40 51 51 51 51 51 51 51 51 51 51 51 41 41 51 51 51 51 51 42 0 30 31 32 0 40 42 0 0 40 42 0 0 40 51 51 51 51 
51 51 51 51 51 51 51 51 41 51 41 51 51 42 0 40 42 0 40 51 51 41 51 51 41 41 51 51 51 51 51 51 51 51 51 41 51 42 0 40 41 42 0 40 42 0 0 40 42 0 0 40 51 51 51 51 
51 51 51 51 51 51 51 41 51 51 51 51 51 52 0 50 52 0 50 51 51 51 51 51 51 51 51 51 51 51 51 51 51 51 51 51 51 42 0 50 51 52 0 50 52 0 0 50 52 0 0 50 51 51 51 51 
